SO ./textures/v1/wall_s.xpm
WE ./textures/v1/wall_w.xpm
NO ./textures/v1/wall_n.xpm
EA ./textures/v1/wall_e.xpm

F 220,100,0
C 225,30,0

DOOR ./textures/val/door.xpm
FLOOR ./textures/v1/floor.xpm
CEIL ./textures/v1/ceil.xpm
GUN ./textures/val/gunz.xpm

111111111111111111111111111111111
11Z000010000001101000000000000001
10000Z010000000001000000000000001
10000001100000000D000000011000001
100E00ZD0000000001000000000000001
10Z000010000000001000010101111111
111111111111D11111000000000000001
100Z00000000000001000000000000001
100000000000000001100000000000001
10000000Z00000000D000000000011001
100000000000000001000000Z00000001
100010000000000001000000000000001
1000000000000000101000010000Z0001
1DDDDDDDDDDDDDDD00100000100000001
100001100000001000100001000000001
100000000000010000010000000000001
1000000000Z001000Z00100Z000000001
100001100000001111110000000000001
100000000000000000000000000000001
111111111111111111111111111111111