SO ./textures/val/wall_s.xpm
WE ./textures/val/wall_w.xpm
NO ./textures/val/wall_n.xpm
EA ./textures/val/wall_e.xpm


F 220,100,0
C 225,30,0

DOOR ./textures/val/door.xpm
FLOOR ./textures/val/floor.xpm
CEIL ./textures/val/ceilling.xpm
GUN ./textures/val/gunz.xpm

          111111111111111111111
          10Z1111D1D10000011001
   111111110100010D01010101Z1011111111
   1D01000100010001010100000001DDD1DZ1
   1Z01010111111111010111111111D1DDD11
   110101010Z0100010101D1000001D111111
   1001010100000101010100010Z01DDDDDD1
   101D0101111111D1D1D1D111111111111D1
   1000010DZZZZZD0000000DDDDDDDDDDDDD1
   11111111111111000000011111111111111111111
    100Z00111000D0000000D00D0100000D1010D001
    101011000001100000001DD10D01111010001101
    10110001111111100011111111D01Z10101Z0001
    1000001100000011D1100001111D10D010100001
    11111111000000000000000Z0011111110111101111111
           100Z001111111110000D0D10001000000010001
           1000001000D00010000110100100000001ZD101
       1111100000100010Z01000011000110000000011101
       1Z0010000010001000D0000D0D10000011100000001
      1111011111110001000100001111111110000Z000111
      10000000100000011D11Z000DZ1000001000111111
      1Z101110100Z000100011111101Z00001011100001
      11100000100000010N010000001000001000D00001
      1000111011110001000101111110000011111D1111
      101110000001000111110001000000Z0DDDZDD1
      101010111101111000000101000000001111111
      100010101000000011101101000000001
      1110001010111110000000010Z0000001
      10001010101Z001111111101000000001
      101110101100100000000001000000001
      1Z1Z00001001111111111111000000001
111111D111111110110000000000000000Z0001
1D000Z0D0000001D100Z0000000000000000001
1000000100Z0111D10000000000000000000001
1000000100000D1D1110000000Z000000000001
10Z0000100001D1D1DZ10000000000000000001
1000000010001DDDDD100Z00000000000000001
10000Z00100Z011D1D100000000000000000001
100000001000001DZ1000000000000000000001
1000000011111D111000000000Z000000000001
10000Z000000000000000000000000000000001
100000000000000000000000000000000000Z01
1111111111111111111111D1111111111111111
                      1
