1111111111111111111111111111111111111111111111111111111111111111111111111111111111111111111111111111
10000100000000000C0000010000010000C000000010000C0000001000000000C00000000000000000010000000000C10001
10000000000000000C00000000000000C00000000000000C0000000000001000001000000000000C00000000000000C00001
1000000000000000000000000000000000000C001000100C000000000C000000001010000000000000000000000010C01011
1000000000000000C000000000000010010000000000000C000100000000000000000100100000C000000000001001000001
11000000000000000000000010000000000001000000000C00000C00000C0000000000001000000000000000001000010001
10000000000000000000101000000000011100000000001C1100C0000C001011000000000000000000000000100000000001
1000000000000000000000000000000000000000000000000000000000C0000000000C0000000000C0000000000C00000001
10000000C000000100000000000000000000100C000001000000000000000000001000C00000000000000000000000000001
1000000000000000000C000000000000100000C010000000000000000C000000000000000000C000000000000000000C0001
10000000000010000000000000000000000010000000000000000C00C00C0000000000000000000000010000000000000011
1000000000001000000000000000000000000000000000001000000000000000010000000000000000C000000C000000C001
10000000001100000100000110C000110000000000001000000000000C000000000000000000000000000000C00000000001
100000000000000000000000C000000000000000000100000C000001000000000000000000C00000000000000000000000C1
10000000000000000000000000000C0000000000C0000000000C000000000000000000000000000000000000000C00000011
100000001000000000000000100000000000000000000000000000000C0C0C00000100000000000100010000000000010001
1000C000000000000010000000000000010C000000000000000000000000000000C000000000000000000100000000000C01
1CC000000000100000000000000000000000000000CC0000000000000000000000000100000000E0100CC000000100000001
1000000000000000100C110001000000000000C000000000000000000C00000000000000000000000C000000000000000001
100000000C00000000C00000010C00000000C00000000C00000000C000000000000000000001100000000000000000000001
1000001000000000001000000000C000000000000000000001000000000C000000001000000001001000000001C000000001
10000000000000000010000C0000000000C000000000000001000000000000000000C0000000000C00000000000000000011
10000010000000000000000010000000000000000C000000C000000C00000000000000100000000000000000001000000001
110000000000100000000C0000000C00000000000000001000C1000000C0000000000000000000000000010C001000000001
1000010000001C010000001000000000000000000000C000000000000000000000000000000C000000000000011000000001
1000000000000000001100000000000000000000000000C000000000011C000010000000C000000000000C000000000011C1
100000000000C000000000000000000000000C00000000000C000000000000100000100000C0000000000000000000000101
1000000000000000000C000000000000000000C000000001000000C000000000000000000C000000000000100C0000000001
10000000000000000000C000000000000000000000000000010C000100000000000000000000000000C00000000000000001
11000000000000C00000000C0000000000000000000000C0000000000000000000000C0000000000000000000000C0000001
10001000000010000000000000000000000000000000000000000000000CCC00000001000000010000000000000000000001
1000000000001000000000000000000000000000000000000000100000000000000000000000000000000000000010000001
10C000000100000000000000000000000C000000000000000010000000000000C000000000000000000000000000001C0001
10001010000000001000000000000000C000000C0000000000000000000000000000001C000000C000000000000000000001
1C0000100000000000000C00000000000000000010C00000000010000000000C0000000000000000000C0000000000000101
1000001000000000C00000000000000000000000000C10000100000000000000001000C000000000000000C0000000000C01
1000000010100000000C000000000000000000000000000000C000000000000000000000000000000C000000000000000001
100C0100000000000000000000C0000000000000000000000000C0000000110000000000000C00C000000000000000100001
100000000C00000000C00000000C0000000000000000000000000000000000000000000C00000000C00000000C0000000001
10000000C000000000000000000000000C0000000C000000000000000000000000C0000000C0000000000000000000000001
10010000010000C000000000000000000010000010000C000000000000000000010000010000C00000000000000000001001
1000000000000000000000C0000000000000000C0000000000000000C0010000010000000C0000000000000000C000000001
11000000000000000C0000000000000000C0000000000000010C000100010000000000000000000C0000000000001000C001
10000000000001000C00000000000000000C00000000000000000C1000000000000001C00000000000000000C00000000001
100100000000100000000000C000000000010000000000000000000C000000000000000000000000000000C0000001000001
1000000010000000000C00000000000000000000C00000100000000000000C00000000010000000000C00000000000000001
1000001000000000000000010C000C0000000000000001000000000000C0001000000000000000000000100C000C00000001
1CCCCCC000000000000000000001000000000000000000000000000000000000100000000010000000000000000000000001
1000001000010000000000C000000000000000000000000000000C000000000000000000000000001000C100000000000001
1000001000000C000000110000C01000000100000010000000C000000000000C000000000000000000000000000000000011
10000000000000000000000C000000001000C000000000000C00100000000000000000010000000000000C000001000000C1
10001000000000C0000000010000C0000000000000C00000000000000000010000000C0000000000100C0000000000000C01
100000C000000000000000000000000100100C000000000000100000000000000000C0000000000000000000000000000001
10000C0000C00000000000000000000000000000000C0000C0000000000000000000000000000000000000C0000C00000001
1100000000000000000C0000000C00000000000000010000000000C00000000000000000000010000C0000000C0000000001
1000000000000100000000C000001000000000000010C000000000000000000000C0000100000000000000000000000C0001
1000000000C000000000000000000000000000000C000000000000000000000000000100C000000000000000000000000011
100C00C00C00C00C00C000000100000000000000000000000000000000010000000000001000000000000000010000000001
1000000C000000000000000C0100000000000000000000C0000000000000010000000C000000000000000C00000000000001
10000C0000C0000C0000C0000C0000C000000000011000000000000001000000000000001000000000000001000000000001
101000100000000000000000000000C000000100000000000000000000000C001001100100000000000000000000C0000011
100000000000000C00000000000000C00000010000000C00000100000010C00000000000000C00000000000000C000000001
1000001000000000000000000010000000000000000000100000000000000000001000000000000000000010000000000001
1000001000000000000000000000000000C00000000000000C00000000000000C00000000000000C00000000000000C00001
1C000000000000000000000001000000C000000000000001000000000000100C000000000000000000100000000000C00001
10000000000100000000000000000000000000001100000000000000000000000000001100000000000000000C0000C00001
1011000010000000C0000000000000000001000C000000000000000C0000001000000000000000C000000000000000000001
1000000000000001000000000000000000000000000000000000000000001000000000000010100000000000001000000011
100100000000000000001C000010000000000000000000000000C000000010000000000000000000000C0000001000000001
1000100C000000000100000000000C100000000000010000000C000010C000000000000000000100C0000000000000000001
10000000C00000000000001000000000010C0000000C00000000000000000000010000C00000000000000000000000000C01
100000000000000000000000000000000C0000C01000010000100001000010000100000C0000C00000000000000000000001
1000110000000000000000000C000000000000000000000000000000C101000000000000000000000000000C000000000001
100000000000000000000000000C0000000000000C0000000000000000000000000000000000000000C0000000000000C001
1000000000000C000000000000C000000000000C00000001000000000000000000010000000C000000000000C00000010001
100000000000000000010000C000000000000C00000000000000000000000C000000000000C00000000000000100000000C1
100000000C000000000100000000000000000000C000000000000010000000000001000C0000000000000000000000000001
1000000000000000000010000000001000000000000000000000P00000000000000001000000000000000000000000000001
1000C0000000000000000000000000000C000C0000000000000000000000000000C0000000000000000000000000000C0001
10C000000000000100000C00000000000000000000C00000000000000000000C00000000000000000000C000000000100001
1000000C000000000100100000000000000000C000000000100100000000000000000C000000000000000000000000000001
100000000000000000C00000000000000000C00000000000000000C0000000000000000000000000000000000C0000000001
10000000000C0000000000000000C0000000000000000C000000000000000000100000000C0000000000000000C000000001
11000000001000010C0000000000000000C0000000000000000C0000000000000000C0000000000000000C00000100001001
10000000000000000C000000000000000000000000000010C000000000000000000000000000000C0000000000001111C101
1000000000000000100000010C000000000000000000000010C0000000C000000000000000000000000C0000001000000101
10000000000000000000000000010000000C00000000C00000000C0000000010000000000000000000000000C01000000C01
10000000000000000000000C0000000000000000000000C0000000000001000000000000C0000000000000000010000C0001
100000100000C000000000000000000000000000000C000000000000000000000000000000C00000000000C0000000000001
10000000000C000000001000100C0000000000C000000000000000C0010000000C000000000100000C0000000000C0000001
10001100000000000000C01110000000000000000C0000000000000000000C00000110000000000000C00111000000000001
1000000C000000C0010000000000000000000000000000C000100C00000000000000000000000000000100000000C0000001
10010000000000000000000000000C010000000000100000000000000000C0000000000000000000000010000C0C00000001
1000100000000000000000000000000000000000000010000000000000000000000000000000000000001000000000000001
1CCC00000000000000000000000000001000010000000000000000000000000CCC0000000000000100001000000000000001
110001000C0000010000000000000000C0000000000000000000000C0000000000000000001000C00000100C000000000011
10010000000C000000000000010000000000000010C000000000000000000000000000000C0000000001C000000000000001
1000000000000000C000000001100000001C000000000000000C000000000000000000C000000000000011C0000000000001
1001000000100C10000001000C000000000000000000000001C000001000100000010000000C000000000000000000010001
1111111111111111111111111111111111111111111111111111111111111111111111111111111111111111111111111111
