1111111111111111
1P0C0000000000E1
1111111111111111