1111111111111111
10PC0000000000E1
1111111111111111