111111111111111111111
1PIIIIIIIIIIIIIIIIII1
111I111I111I11111I111
1IIIII1I1IIIII1IIIII1
1I111I11111I1I111I111
1I1III1IIIII1III1III1
1I1111111I11111I11111
1I1I1IIIIIII1I1III1I1
1I1I111I11111I11111I1
1IIIII1I1I1I1IIIII1I1
1I11111I1I1I1I111I1I1
1I1IIIIIII1III1I1I1I1
11111I1I11111I1I1I1I1
1IIIII1IIIII1III1III1
1I1I1I111I1I1I1111111
1I1I1III1I1IIIIIIIII1
1I1111111I111I1I1I1I1
1I1IIIII1I1I1I1I1I1I1
1I1I1I111I1I111111CI1
1III1I1IIIIIII1IIIIE1
111111111111111111111