1111111111
1C00100111
1000100101
1000000001
1110000001
1000000001
1000000001
1110000011
1100P001E1
1111111111
