1111111111111111111111111111111111111111
10000000011000000C0000000000000011C00001
10000000000000001C00000000000000C0000011
1001000000000000000000000010000001000C01
1000000010000000C00100000000000000000001
1000000000010000000000000000010000000011
1000000000000100000000000000100000100001
1000000000000000000000001011000000000001
10001000C0000000000001001000000000000011
1100000000110000000C110000000000000000C1
1100000001100000000000000100000000100001
1000010001000000000000000000000001000111
10000000000000111100000000C0010110000001
100000100000011000000100C100000011000001
10000000000011000000110000000C0001100001
100000000000100000000P000000000000000001
1010C000000010000001000010000000000C0001
1CC0000000001000000010001000100000001001
1000000000000000000C000000000000001000C1
100010000C00000010C00010000C00010000C001
10000000010000100100E0100010C00000010011
10000000110001100000001C0000000000C00001
1000000000000000000111100000000000001111
100000000000000000000C0000000C0111111101
1000000110000C00110000000000000011000001
1000000000100100000000000000110000000011
100100010000C000000010000001000000000C01
1000000100000000000C000000100000001010C1
10000010000000000100C0000100000010001011
10000100000010C00000000C0100000010000001
1000000000000000000000000000000000000001
1000000000001000000100010000000000110001
11C000000000110000000001100011000C000001
11010000000101100000000110000000C0001001
1C0000100010001000100C010001000100010111
1000000000000000C00010010000000100100001
1000000000000000010C00110001100001000001
100C0000000100000000001100C0000000100111
101001001C01000000C01010010C100000100101
1111111111111111111111111111111111111111
