111111111111111111111111111111
10000011100000000C100000000001
10011000000000000C100000000001
101000000000100000000010000001
1010000001000000C0000000000001
100000000000000000000100000101
110000100001000000000000000001
110000000001000100000010000001
11000000C000000000000001000011
1000100000000001000CP000000011
100000000000000000000000001101
10000011000E001100000111000001
10010000000000000000010001C001
100000000000000000000000C00001
100000000001000000100000000001
100000010101000000101010100001
1000C0000000000000000000000001
1CC000000000000001001000000111
1110000000000011000C1100000001
100000000C00000000C00111000C01
1000000000000001011000000000C1
10000100000110000011000C011001
100100010001000100010001000101
100000001001000000010C10010001
1000000000000C0100000000000001
100000000000100000000101000011
100000000010C00000000100000001
1000010000100000010C0010000101
10000000110000000100C000010001
111111111111111111111111111111
