11111111111111111111
1010E000100010100C01
11001011000001000C01
10001000010001010101
1011000000000010C001
10000000010000101111
10100000000000111111
10100000101010100001
11000001C01010000001
10010100001010010101
10000001111001000111
10000000000001100011
11000001110000011111
10110000001101100101
11001111000101000001
10010010010010000111
1000C1100P0010000111
1CC10110011011011001
10000110001110011001
11111111111111111111
