11111
1CPE1
10101
11001
11111
