11111111111111111111111111111111111111111111111111
10000000000000000C0000000000000000C000000000000C01
10001000000010000C00100000000000C01000011000001C11
1000000010000100000000000011111111110C000000001C01
1010001000100000C000110111101101100000000000000C01
10000100100101001000111101000000001001000000000C01
10001000000001111100000000000000001010000011111C01
10000000000011011100000000000000001110010000000101
10010100C010111010000001000100000000000C0000000011
1000000001110000010C000100000000000100C00001100001
10001000111100000000000000000000010000111000101001
10000100011000000000001000000010000000101000000001
10100001100000000110011100C00000000001000001001111
100101111000010000001100C0000011000000001100000001
10000010100000000000000000000C0100100010C000000001
1000001100000000000001000000000000110110P000000001
1000C111100000000000000000000000001C00000000000001
1CC000110100100000000000000100000000000000CC010011
1000000000001000000C001000000100000000C00000011011
100000000C00000000C11110010C11100000C00000000C0001
1010110000000100000110100000C001000000000000000001
10001100000011010001000C0000000001C000000000000111
10000100000110000011100000000000000000000C001110C1
100011001100100000000C0000010C00001000000001100001
1000100000000C000000000000000000001000000110C00101
1000110000000000000100000000001001100000100001C001
100110000000C000000000000000000011010C000000110001
1001000010000000010C000100000011100001C00010000011
10011000000000000001C00000000000000110001110100001
10011000000000C00011000C0000011000110101100001C101
10010000000101000001000001010100000001010001000101
100110000000011000001000000100000000110000E0001101
10C110000000000000000000001100000C1100000000000001
10010000001000000000010001100000C010000C0001000011
1C1101110000001110000C01110001001100011001C0001001
1001000101000001C00000000010110010000000010C000001
1000001100000000000C000000001001000000010000000011
100C0100000010010000000000C10111001000000000000001
100000000C11001100C00000000C0000001000110110000001
10100001C010000000000000000001100C0010100C00000001
10100000001101C000000000010011000000000000000C0001
1000000000000100000000C0100010000011001C0000011001
10000010000000000C0000001001100000C000100000010111
10000010010010000C00000100000010010C00000000000001
100000100110000000000011C0101000000000000000000001
1000001000000000011C00100110010000000000C110000001
10110010M0101000001000100C000C01001000000100000011
1CCCCCC1000010000000010010000111000000000010000001
1010000010001000011001C0000100000100100000100010M1
11111111111111111111111111111111111111111111111111
