1111111111111111111111111111111111111111111111111111111111111111111111111111111111111111111111111111
100000000000000000000C000000000000C000000000000C00000000000000000000C000000000000C000000000000C00001
10000000000000000C0000000000000000C000000000000C0000000000000000C00000000000000000000000000000C00001
1000000C0000000000000000000C0000000000000000000C00000000000000000000000000C0000000000000000000C00001
10000000000000000C00000000000000C00000000000000C0000000000000000000000000000000C00000000000000C00001
10000000000000000000000000000000000C00000000000C00000000000C0000000000000000000000000000000000C00001
1000000000000000000000000000000000000C000000000C000000000C000000000000000000000000000000000000C00001
100C000000000000000000000C000000000000000000000C000000000000000000000C000000000000000000000C00000001
1000000000000000C000000000000000000000000000000C000000000000000000000000000000C000000000000000000001
100000000C0000000000000000000000000000C00000000C0000000000000000000000000000C00000000C00000000000001
10000000000000000000000000000000000000000000000C00000C00000C0000000000000000000000000000000000000001
10000000000000000000000000000000000000000000000C0000000000000C0000000000000C0000000000000C0000000001
10000000000000000000000000000000000000000000000C0000C0000C000000000000000000000000000000000000000001
100000000000000000000000000000000000000000000000CC00000000000000000000000000000000000000000000000C01
1000000000000000000000000000000000000000000000000000000000C0000000000C0000000000C0000000000C00000001
100000000000000000000000000000000000000000000000000C000C000C0000000000000000000000000000000000000001
10000000C000000000000000000000000000000C000000000000000000000000000000C00000000000000000000000000001
10C0C00000000000000000000000000000000000000C0C00000000000000000000000000000000000000C0C0000000000001
1000000000000000000C000000000000000000C000000000000000000C0000000000000E0000C000000000000000000C0001
100000000000000000C00000000000000000C00000000000000000C00000000000000000C00000000000000000C000000001
10000000000000000000000000000000000000000000000000000C00C00C0000000000000000000000000000000000000001
1C000000000000000000000C0000000000000000000000C000000000000000000000C0000000000000000000000C00000001
1000000000000000000000000000000000000000000000000000000000000000000000000000000000C000000C000000C001
100000000000000000000C00000000000000000000C000000000000000C00000000000000000000C00000000000000000001
10000000000000000000000000C000000000000000000000000000000C000000000000000000000000000000C00000000001
1000000C0000000000000000000000000C0000000000000000000000000C0000000000000000000000000C000000C0000001
100000000000000000000000C000000000000000000000000C000000000000000000000000C0000000000000000000000001
100C0000000000000000000000000000000000C0000000000000000000000000000000000C00C000000000000000P0000001
10000000000000000000000000000C0000000000C0000000000C000000000000000000000000000000000000000C00000001
1000000000000000000000000000C00000000C00000000C000000000000000000000000000000000000C00000000C0000001
100000000000000000000000000000000000000000000000000000000C0C0C00000000000000000000000000000000000001
1000000000000000000000000000000000000000000000000000000000000000000000000000000000000000000000000001
1000C000000000000000000000000000000C000000000000000000000000000000C000000000000000000000000000000C01
1000000000000000000000000C0000000000000C000000000000000000000000C0000000000000C000000000000000000001
1CC000000000000000000000000000000000000000CC000000000000000000000000000000000000000CC000000000000001
10000C00000000000000000000000000C00000000000000000000000000C00000000000000000000000000C0000000000001
1000000000000000000C000000000000000000C000000000000000000C00000000000000000000000C000000000000000001
100000C0000000000000000000000C0000000000000000000000C0000000000000000000000C00000C000000000000000001
100000000C00000000C00000000C00000000C00000000C00000000C000000000000000000000000000000000000000000001
1000000000000000C0000000000000000C000000000000000C0000000000000000C000000000000000C00000000000000001
1000000000000000000000000000C000000000000000000000000000000C000000000000000000000000000000C000000001
10000000000000000000000000000000000000000000C0000000000000000C0000000000000000C0000000000000000C0001
10000000000000000000000C0000000000C000000000000000000000000000000000C0000000000C00000000000000000001
10000000000000000C0000000000000000C000000000000000000C0000000000000000C0000000000000000C000000000001
10000000000000000000000000000000000000000C000000C000000C00000000000000000000000000000000000000000001
10000000000000000C00000000000000000000C00000000000000000000C00000000000000000000C0000000000000000001
100000000000000000000C0000000C00000000000000000000C0000000C0000000000000000000000000000C000000000001
1CCCCCCCCCCCC000000000000000000000000000000000000000000000000000000000000000000000000000000000000001
1000000000000C000000000000000000000000000000C000000000000000000000000000000C000000000000000000000001
1000000000000C000000000000C000000000000C000000000000C00000000000000000000000000000000000000000000001
1000000000000000000000000000000000000000000000C000000000000C000000000000C000000000000C00000000000001
100000000000000C000000000000C000000000000000000000000000C000000000000C00000000000000C000000000000C01
100000000000C000000000000000000000000C00000000000C000000000000000000000000C0000000000000000000000001
1000000000C000000000C0000000000000000000000C000000000C000000000C0000000000000000000000C000000000C001
1000000000000000000C000000000000000000C000000000000000C000000000000000000C000000000000000C0000000001
100000000000000C0000000000000000000000000000C00000000000000C0000000000000000000000000000C00000000001
10000000000000000000C000000000000000000000000000000C000000000000000000000000000000C00000000000000001
100000C00000C00000C00000C00000C00000C000000000000000000000000000000000000000000000000000000000000001
10000000000000C00000000C0000000000000000000000C0000000000000000000000C0000000000000000000000C0000001
10000C0000C0000C0000C0000C0000C0000C0000C0000C0000C0000C0000C0000C0000000000000000000000000000000001
10000000000000000000000000000000000000000000000000000000000CCC00000000000000000000000000000000000001
10000000000C000000000000000000C0000000000C000000000000000000C0000000000C000000000000000000C000000001
1000000000000000000000000000000000000000000000000000000000000000000000000000000000000000000000000001
10000000000000000000000000000000000000000000000000000C00000000000000C00000000000000C0000000000000001
10C000000000000000000000000000000C000000000000000000000000000000C000000000000000000000000000000C0001
10000000000000000000000000000000000000000000000000000000000C000000000C000000000C000000000C0000000001
10000000000000000000000000000000C000000C0000000000000000000000000000000C000000C000000000000000000001
1000000000000000000000000000000000000000000000000000000000000000000000000000000000000000000000000001
1C0000000000000000000C00000000000000000000C00000000000000000000C0000000000000000000C0000000000000001
1000000C000000C000000000000000000000000000000000000C000000C000000C0000000000000000000000000000000001
1000000000000000C00000000000000000000000000C00000000000000000000000000C000000000000000C0000000000C01
1000000000000000000000000000000000000000000000000000000000000C0000C0000C0000C00000000000000000000001
1000000000000000000C000000000000000000000000000000C000000000000000000000000000000C000000000000000001
100000000000000000000000000C00000000000000000000000000C000000000000000000000000000C00000000000000001
100C0000000000000000000000C0000000000000000000000000C0000000000000000000000C00C000000000000000000001
10000000000C0000000000000000000000000C0000000000C0000000000000000000000000C0000000000C00000000000001
100000000C00000000C00000000C0000000000000000000000000000000000000000000C00000000C00000000C0000000001
1000000000000000000000000000000000000000000000000000000000000000000000000000000000000000000000000001
10000000C000000000000000000000000C0000000C000000000000000000000000C0000000C0000000000000000000000001
1000C000000000000000000C000000000000000000C0000000000000000000000C000000000000000000C000000000000001
10000000000000C000000000000000000000000000000C000000000000000000000000000000C00000000000000000000001
1C0000000000000000000000000000000000CC0000000000000000000000000000000000C000000000000000000000000001
1000000000000000000000C0000000000000000C0000000000000000C0000000000000000C0000000000000000C000000001
10000000000000000000000000000C0000C0000000000000000000000000000C0000C0000000000000000000000000000C01
10000000000000000C0000000000000000C0000000000000000C000000000000000000000000000C0000000000000000C001
100000000C000000000000000C000000000000000000000000C000000000000000000000000C000000000000000000000001
10000000000000000C00000000000000000C00000000000000000C0000000000000000C00000000000000000C00000000001
1000000000000000000000000000000000000000000C00C000000000000000000000000000000000000000000000C00C0001
100000000000000000000000C000000000000000000000000000000C000000000000000000000000000000C0000000000001
10000000000C0000000000C0000000000000000000000000000000C0000000000C0000000000C00000000000000000000001
1000000000000000000C00000000000000000000C00000000000000000000C00000000000000000000C00000000000000001
1000000C000000C000000C000000C000000000000000000000000000000000000000000000000000000000000000C0000001
1000000000000000000000000C000C0000000000000000000000000000C0000000000000000000000000000C000C00000001
1000000000000000000000000000000000000000000000000000000000000000000000000000000000000000000000000001
1CCCCCC000000000000000000000000000000000000000000000000000000000000000000000000000000000000000000001
100000000000000000C0000000000000000000000C0000000000000000000000C0000000000000000000000C000000000001
1000000000000000000000C000000000000000000000000000000C000000000000000000000000000000C000000000000001
1000000000000C000000000000000000C000000000000000000C000000000000000000C000000000000C0000000000000001
1000000000000000000000000000000000000000000000000000000000000000000000000000000000000000000000000001
1111111111111111111111111111111111111111111111111111111111111111111111111111111111111111111111111111
