11111
1C1P1
11001
10001
10E01
11111
