111111111111111
100000100110101
100101000000101
101101101011001
100000111000101
101100101011101
110111011010001
100010100001001
10011110C000011
110000000000M01
11P101E00000001
10010101000M001
111011000000001
100000001000001
111111111111111
