1111111111
1C001S0001
1010010101
1000000001
1100010001
10101M0011
1000000001
1010000001
1000P100E1
1111111111
