1111111111
1C00100001
1010010101
1000000001
1100010001
1010100011
1000000001
1010000001
1000P100E1
1111111111
