11111111111111111111111111111111111111111111111111
10010101000000000C0010001101010000C000000010101C11
10000000000000000C00000010000010C01100000000111C01
1100000000000000110010000000001100001C000100100C01
1000000000111001C100001100011000000000000000110C01
11000100100000000000001000000000000000000000000C01
10000000101100000011001000000001010000010000000C01
11000000001000000001001000000001000000000000000001
10000110C001000000010010000000000000011C0001000001
1000000000001000000C001000100100000010C00001000001
10001011000000000000000000100000000000000000000101
10001010100001100010000000000000000001000011000101
10001000010001000000000000C10001000001000001000011
100000000001100000100000C0001000001000000000000001
10000000000100000000000000101C0001010000C000000001
1000100000000000000000000011000001100000P000000001
1001C000000000000001100000000000000C00100000000011
1CC110000000000001000000001000100000000110CC000001
1000001000010100001C000000000000000010C10101110001
100000111C00000010C00000000C00001000C11000001C0011
1101000000000000100000000000C110000000000000000011
10000000000000000000001C0100000000C000000000000001
10001111110000000000010000000000011111110C000000C1
100010000000000000000C0000000C00000101010000000011
1110000000000C000000000001010000000010111000C00001
1100000000000000000001001000000000000000101010C001
100000000110C011010000000000000000100C000000000001
1100100000001001000C000010000000100000C00000100001
10001000000001100000C00000000000000000001100110001
11000000010000C00000100C0000000100000000000000C001
10110000000000000100100000000000000100110000000001
100100110000100000000000000001000001000100E0000011
10C000000000000000010000000100000C0000000001000001
10000010000000110000001000000000C001100C0001000001
1C1000000000010100000C10001000000001010000C0000001
1010000000000010C00000110000001101100100000C000111
1001000001000000001C001010000000010000010000000011
100C0000100110000001001100C00000001101100000000001
100000001C00000010C10010100C0010000001100000000111
10000010C000000001100011100000110C0010000C00000111
10000000000000C101000000110010000000000001100C0001
1001000000000001001000C0000010000000000C1001100001
11000000000100000C0000000100000000C000001001110011
10000000110110000C10000000000000110C00000110110001
111110000000000000110000C1011000000000000111000001
1010100000000000001C00000000100000000000C011000001
1110000000000000000000000C000C00000000000000000001
1CCCCCC0001100000000000000000000000100110000000001
1100000000001000100110C100000001000110110010000001
11111111111111111111111111111111111111111111111111
